#######
###IIF#
###I#K#
#III#K#
#I###K#
#III^K#
#######