#######
#F  #v#
### # #
#   # #
### # #
#     #
#######