79
13
#################
#4BWTL###F#D#   #
#2III KK# # ### #
#WWWWI L# #   # #
#44 BW#T# # ### #
#WWWWIK #   # # #
#WWW  #K### # # #
#2W^ # K#       #
###### #### ### #
#       # #2    #
#####I# # ### ###
#R   I# #       #
#####I# # #######
#   # # #   # # #
# # # ### # # # #
# #       #     #
#################